------------
-+........+-
-+........+-
-+........+-
-+........+-
-+...@....+-
++++++++++++
------------