--------------------------------------------
-++++++++++++++++++++++++++++++++++++++++++-
-+.........+..............................+-
-+.......@.+..............................+-
-+....++++++.......................+++++..+-
-+....+----+.......................+---+..+-
-+....+----+.......................+---+..+-
-+....+----+.......................+---+..+-
-+....+----+.......................+---+..+-
-+....+----+.......................+---+..+-
-+....+----+.......................+---+..+-
-+....+----+.......................+---+..+-
-+....+----+.......................+---+..+-
-+....+----+.......................+---+..+-
-+....+----+.......................+---+..+-
-+....++++++.......................+---+..+-
-+.................................+---+..+-
-+.................................+---+PP+-
-+++++++++++++++++++++++++++++++++++---++++-
--------------------------------------------