----------
-........-
-........-
-........-
-........-
-...@....-
----------