------------
-++++++++++-
-+........+-
-+........+-
-+......+++-
-+.....++-+-
-+@..+++--+-
-+++++------
-------------